%%%%%%%%
%      %
% %    %
% %%%% %
% %   P%
% %    %
% %  % %
%.%  % %
%%%%%%%%